Компания - Тикер"Аптечная сеть 36,6" - APTK
Артген - ABIO
Банк Санкт-Петербург - BSPB
ГТМ - GTRK
Газпром - GAZP
Интер РАО - IRAO
КрасныйОктябрь - - KROT
Лензолото - LNZL
М.видео - MVID
МКБ - CBOM
МОСТОТРЕСТ - MSTT
Магнит - MGNT
Магнитогорск.мет.комб - MAGN
НЛМК - NLMK
НОВАТЭК - NVTK
Нижнекамскнефтехим - NKNC
Россети Кубань - KUBE
Россети Центр - MRKC
РусГидро - HYDR
Русолово - ROLO
СОЛЛЕРС - SVAV
Селигдар - SELG
Славнефть-Мегионнефтегаз - MFGS
ТГК-1 - TGKA
Татнефть - TATN
Таттелеком - TTLK
Уральская кузница - URKZ
Центральный Телеграф - CNTL
ЧМК - CHMK
ЭЛ5-Энерго - ELFV
Яковлев ак.об.-3 - IRKT
«ЛК «Европлан» - LEAS
АКБ АВАНГАРД - AVAN
АЛРОСА - ALRS
АФК Система - AFKS
Абрау-Дюрсо - ABRD
Авиакомпания ЮТэйр - UTAR
Акрон - AKRN
Ашинский метзавод - AMEZ
Аэрофлот-росс.авиалинао - AFLT
БАНК УРАЛСИБ - USBN
Банк ВТБ - VTBR
Башнефть АНК - BANE
Белон ОАО - BLNG
Бурятзолото - BRZL
ВУШ Холдинг - WUSH
ГАЗ - GAZA
ГК ТНС энерго - TNSE
ГК РБК - RBCM
ГК Самолет - SMLT
ГМК Нор.Никель - GMKN
Газпром нефть - SIBN
Группа Аренадата - DATA
Группа Астра - ASTR
Группа ЛСР - LSRG
Группа Позитив - POSI
Группа Черкизово - GCHE
ДВ морское пароходство - FESH
Детский мир - DSKY
Диасофт - DIAS
ЕвроТранс - EUTR
Займер - ZAYM
ИНАРКТИКА - AQUA
Ижсталь ао 2в. - IGST
КАМАЗ - KMAZ
Каршеринг Руссия - DELI
Корп. ВСМПО-АВИСМА - VSMO
Коршуновский ГОК - KOGK
Левенгук - LVHK
Лента МК - LENT
МГКЛ - MGKL
МК«МД Медикал Груп» - MDMG
МКХэдхантер - HEAD
МКЭН+ ГРУП - ENPG
МКЯНДЕКС - YDEX
МТС-Банк - MBNK
Международная компания ВК - VKCO
Мечел - MTLR
Мобильные ТелеСистемы - MTSS
МосЭнерго акции обыкн. - MSNG
Московская Биржа - MOEX
НК ЛУКОЙЛ  - - LKOH
НК Роснефть - ROSN
НКХП - NKHP
НМТП - NMTP
ННК-Варьеганнефтегаз - VJGZ
НПК ОВК - UWGN
НПО Наука - NAUK
НоваБев Групп - BELU
ОГК-2 - OGKB
Об.авиастр.корп. - UNAC
Озон Фармацевтика - OZPH
ПИК СЗ - PIKK
Павловский автобус - PAZA
Полюс - PLZL
РКК Энергия им.С.П.Королева - RKKE
РОСБАНК - ROSB
РОСИНТЕР РЕСТОРАНТС - ROST
РУСАЛ ОК МК - RUAL
Распадская - RASP
Ренессанс Страхование - RENI
Россети Волга - MRKV
Россети Ленэнерго - LSNG
Россети Моск.рег. - MSRS
Россети Сев. Кавказ - MRKK
Россети Северо-Запад - MRKZ
Россети Сибирь - MRKS
Россети Урал - MRKU
Россети Центр и Приволжье - MRKP
Россети Юг - MRKY
Ростелеком  ао. - RTKM
РуссНефть НК - RNFT
СПБ Биржа - SPBE
СТГ - CARM
Саратовский НПЗ - KRKN
Сбербанк России - SBER
Северсталь ао - CHMF
Сегежа - SGZH
Славнефть-ЯНОС - JNOS
Совкомбанк - SVCB
Совкомфлот - FLOT
Софтлайн - SOFL
Сургутнефтегаз акции об. - SNGS
ТКС Холдинг МК - T
ТМК - TRMK
ФСК - Россети - FEES
Фармсинтез - LIFE
ФосАгро - PHOR
ХЭНДЕРСОН - HNFG
Элемент - ELMT
ЭсЭфАй - SFIN
ЮГК - UGLD
Южно-Уральский никел. комб. - UNKL
Южный Кузбасс - UKUZ
Юнайтед Медикал Груп - GEMC
Юнипро - UPRO
Якутская топл.-энерг. комп. - YAKG
